NO ./textures/





		SO 						./textures/
  EA        ./textures/
WE ./textures/

F
C

1111111
1111111
10  001
1000001
1001001111
10000000011
100000000111
100000000111
100000000111
111110000011111
    10111000001
    101 10N1111
    1 1 100001
        111111