NO ./textures/
SO ./textures/
EA ./textures/
WE ./textures/

F
C

1111111
10  001
1000001
100N001
1000001
1000001
1111111