NO ./textures/





		SO 						./textures/
  EA        ./textures/
WE ./textures/

F
C

1111111
1111111
10  001
1000001
100N001111
10000000011
100000000111
100000000111
100000000111
111110000111111
    10111000001
    111 1111111
