NO textures/s_slay.xpm
SO textures/farquaad_bed.xpm
EA textures/shrek_bed.xpm
WE textures/full_shrek.xpm
F 59,24,4
C 0,160,255

                        1111111111111111111111111 
                        1000000000110000000000001 
                        1011000001110000000000001
                        100100000000000000W0000011             10
                111111111011000001110000000000001
                10000000011000001110111111111111 
                11110111111111011100000010001 
                11111111111111111101010010001
                11000000110101011100000010001               
                10000000000000001100000010 01
                10000000000000001101010010001
                1100000111010101111101111000111
                11110111 1110101 101111010001
                11111111 1111111 111111111111